      C 2,2,2
      NO        ./map.cub   

        SO ./map.cub

  WE ./map.cub






EA ./map.cub
 F 12,12,12



        1111111111111111111111111
        1000000000110000000000001
        1011000001110000000000001
        1001000000000000000000001
111111111011000001110000000000001
100000000011000001110111111111111
11110111111111011100000010001
11110111111111011101010010001
11000000110101011100000010001
10000000000000001100000010001
10000000000000001101010010001
11000001110101011111011110N0111
11110111 1110101 101111010001
11111111 1111111 11111111111



222222221111111111111111111111111
222222221000000000110000000000001
222222221011000001110000000000001
222222221001000000000000000000001
111111111011000001110000000000001
100000000011000001110111111111111
111101111111110111000000100012222
111101111111110111010100100012222
110000001101010111000000100012222
100000000000000011000000100012222
100000000000000011010100100012222
11000001110101011111011110N011122
111101112111010121011110100012222
111111112111111121111111111112222