C   155,155,155
F 45,77,54
NO    ./Textures/wall42.xpm  
SO    ./Textures/wall42.xpm  
EA  ./Textures/wall42.xpm  



WE     ./Textures/wall42.xpm
1        1           11
   1 11   11 1      101
11 1 11  1011      111 1  111
11111     1S1    111111
  1       1111   111111

11110111111111011100000010001
11110111111111011101010010001
11000000110101011100000010001
10000000000000001100000010001
10000000000000001101010010001
1100000111010101111101111010111
11110111 1110101 101111010001
11111111 1111111 1111111111111111111111